(dí)dōmi = geben
(gí)gnōskō (gnōwa) = wissen
(ī́)wēmi = Schlag
(jí)jēmi = vertreiben
(kí)kōmi = schärfen
(pím)plēmi = füllen
(pím)prēmi = brennen
(s)úperi = über
(s)úperos = überlegen
(s)upmos = uppest
(sí)stāmi = Stand
(sí)stāmi antí/prāi = Vorteil
(sí)stāmi apó = weit
(wí)weimi = Jagd
(wí)wermi = finden
ábelos = Apfel
abhnós = plötzliche
abhro- = sehr
acnos = Lamm
ad = bei
adejō = vorbereiten
adghō = kämpfen
ādmi = trocken
admṇ = Ritus
ados = Dinkel
āghar = Angst
ágherom = See
aghjā = Pflug-Tier
aghlós = abstoßend
aghlóws = Nieselregen
ághneumi   = plagen
agīnós = Ziege
aglā = Brut
agm∂n  = Rang
agō = Push
agós = rammen
agos = Fehler
agrā = Massaker
ágrēnom = Obst
agróqolās = Landwirt
agros = Land
agslā = Flügel
agtós = geschoben
ág∂lis = wendig
aichesājō = sich-schämen
aidhis = Herd
aidhō = brennen
aigā = Eiche
aigros = krank
aikō = treffen
áimneumi = Kopie
aimom = Replikation
ainō = beziehen
áinumoi = Besitz-nehmen
aiqos = auch
airā = Weidelgras
aisdai = Ehre
aisdhom = Glut
aiskrós = klar
aisō = Achtung
áisoskō = Anfrage
aisskā = Wunsch
aitis = Teil
áiw(es)i = immer
áiwesos = Zeitraum
aiwós = ewig
áiwotāts = Ewigkeit
aiwu = Lebensenergie
ájeri = früh
ájesnos = blechern
ajos = Messing
akējō = scharf-sein
ákeris = Ahorn
ákeswos = Haufen
akjēs = Klinge
akmā = Bit
akmōn = Stein
aknā = prickeln
áknāmi = essen
akōkós = scammony
akos = Spreu
akris = scharf
akrom = Vorgebirge
áksijā = Axt
aksis = Achse
aksteinos = Besen
ákulos = Stachel
akus = Nadel
alā! = hallo
alājai = Spaziergang
albhos = Weiß
alchos = Geld
aldhōn = Trog
alēiks = Dinkel
álesnos = Erle
alghējō = frieren
aljos = ein-anderes
áljote = Ort
alkejō = schützen
alkis = Reh
alō = nähren
alpos = klein
álteros = andere
altjos = Erwachsene
altós = hoch
álumṇ = Bier
amāyō = Liebe
ambhí = rund
ambhíagtos = Beamter
ámbhinom = Schaltung
ambhíqolos = Diener
ambhírēmos = Reisen
ambhou = beide
ámeikā = Freund
amēiks = Freund
ámetā = Tante
amghō = bedrücken
amghús = schmal
ámghustis = Enge
āmi = Wärme
ammā = Mutter
āmós = Beschlagnahme
amrós = sauer
āmros - āmrei = Morgen
amsus = Urheber
an = vielleicht
ana = auf
ándhesā = Dienstmädchen
andhos = blind
anghwis = Schlange
anglos = Artikulation
anjō = zurückziehen
ankos = Haken
anksi = vor Morgengrauen
ánksitjom = vor Morgengrauen
annā = Oma
anos = Ring
ansā = Griff
ansātos = Griff
anta = Richtung
antas = Säulengang
antí = vor
ántijos = antik
ántitjos = klassischen
antjās = Franse
antjom = Ende
antrom = Höhle
anus = Großmutter
an∂mos = Atem
an∂ts = Ente
apmṇ  = Befestigung
apnis = Bach
apo = von
apóqitis = Rache
ápōqos = rückwärts
apóst∂tis = Abstand
apóteri = hinter
apóteros = Hinweis
apowésentis = abwesend
ápowoiks = Kolonie
appās = Papa
apros = Wildschwein
āps = Wasser
apsā = asp
apsos = Glied
aqā = Wasser
ar = daher
arājō = Pflug
árarjō = anpassen
arātrom = Pflug
árdejā = Reiher
ardis = Punkt
argis = Weiß
árgṇtom = Silber
argrós = brillant
argujō = Grund
arjos = Herr
ármṇtom = Vieh
armos = Arm
arom = Schilf
arqos = Bogen
arti = genau
artis = Kunst
artus = Joint
árusā = Haselnuss
arwā = Butter
arwom = Feld
āsā = Altar
āsējō = trocken-sein
āsos = Asche
astris = Habicht
astus = List
ati = wieder
atiloiqos = Überbleibsel
atis = Fleckbrasse
atlos = edel
ātmós = Atem
atnos = Jahr
ātō = atmen
atqe = und
ātros = schwarz
attās = Papa
audhos = Herr
augā́ = Blick
augējō = Vergrößern
āugejō = aument
augmṇ = Erhöhung
augō = Erhöhung
augos = Entwicklung
augtós = gewachsen
aulos = Rohr
auqslā = Topf
ausijō = leer
ausom = Gold
ausōsā = Morgendämmerung
ausrom = Morgen
áussketi = Morgendämmerung
áusteros = Ost
aw = Howbeit
awā = Brunnen
awējō = Wunsch
áweljā = Brise
awigsnā = Hafer
áwijā = Großmutter
awis = Vogel
awisdhijō = fühlen
awṇ  = Brunnen
awō = verbringen
áwontlos = Onkel
awos = Großvater
awou = zurück
awti = oder
awtim = andernfalls
awtjos = mittellos
ā́lujos = Knoblauch
ā́peros = Ufer
badjos = orange
baitā = Rock
baktlom = Verein
bálbalos = barbarisch
balbos = Zunge-gebunden
bámbalos = Trommel
batā = Geplapper
baubājai = Rinde
bebājō = blöken
belom = Stärke
bélowents = stark
bendā = Ende
bendlā = Fingerling
bewō = feucht
bhabhā = Bohne
bhāghus = Arm
bhagjō = braten
bhagō = Attribut
bhagos = Teil
bhāgos = Buche
bhalnós = Penis
bhāmā = Gerücht
bhāmoi = sprechen
bhām∂n = Rede
bháneumi = beleuchten
bhānis = Satz
bhānom = Beleuchtung
bhānús = hell
bhāos = Licht
bhar = Weizen
bhardhā = Bart
bharkos = Brosche
bharseinā = Weizen
bharsjom = Brot
bharwos = Tannenbaum
bhaskis = Bündel
bhāsos = Geier
bhātis = Ausdruck
bhebhros = Biber
bhecō = laufen
bhedhō = erfordern
bhegō = zügeln
bheidhō = Vertrauen
bheikos = Abb.
bheiqlā = Biene
bheitlom = Axt
bheldō = klopfen
bhelēks = Wasserhuhn
bheljō = verbessern
bhelō = Lärm-machen
bhelō = fluoreszieren
bhelu = Schwäche
bhélunā = Bilsenkraut
bhemṛ = Schenkel
bhendhō = binden
bhendhros = Kumpel
bhendos = melodiös
bhenjom = Hit
bherāgs = Birke
bherghō = halten
bherkō = Schimmer
bhermi (bherō) = Bär
bhermṇ = Belastung
bhernā = Verletzung
bhersi = schnell
bherwō = kochen
bhesmi = Schlag
bheudhō = aufwachen
bheughō = gelingen
bheugō = falten
bheurō = kneten
bhéwedā = Gewinn
bhewmi = werden
bhéwonom = Realität
bhewtis = Natur
bhewtlom = Umwelt
bhíbheimi = Angst
bhidhós = Schiff
bhidrós = bitter
bhilis = gut
bhínāmi = Streik
bhindō = spalten
bhītós = geschlagen
bhlādhrom = Fan
bhlaghmṇ = Priester
bhlagō = Hit
bhlaidos = klar
bhlakkos = dünn
bhlāmi = Schlag
bhledō = prahlen
bhleicō = Hit
bhleidō = aufblasen
bhlēmi = weinen
bhlendhos = schwach
bhleucō = Fluss
bhleugsmṇ = Stream
bhleumi = schwächen
bhleusō = Choke
bhḷgējō = Schimmer
bhḷkjō = Unterstützung
bhlokos = Flocke
bhlōros = weiß-gebeizt
bhlōs = Blume
bhlosējō = Blüte
bhloskos = Skandal
bhlōtis = Blume
bhlōwos = Gelb
bhl∂gsmā = Flamme
bhṇghus = Schwanz
bhodhjō = graben
bhodhwos = Verbrühung-Krähe
bhodjós = besser
bhodrós = ausgezeichnet
bhodsā = Grab
bhogā = Guerilla
bhogājō = kämpfen
bhogjos = Gauner
bhoglā = Stream
bhoidhos = hässlich
bhoidos = hässlich
bhoiqos = Drohne
bhokos = Flamme
bholghis = Beutel
bhōljóm = Höhle
bholjom = Blatt
bholos = Dampf
bholós = laut
bhondhsā = Krippe
bhōr = Dieb
bhorājō = Bohrung
bhorcos = rau
bhoros = getragen
bhorsos = stolz
bhosos = barfuß
bhoudhejō = wecken
bhougā = Flucht
bhougājō = fliehen
bhōwijós = günstig
bhragrājō = Geruch
bhrātēr = Bruder
bhrātreinos = Bruders-Sohn
bhrā́trijos = brüderlich
bhrēgō = Glanz
bhreicō = braten
bhremō = grunzen
bhrendhō = sptruetzen
bhrenō = Kante
bhresjō = zerbrechen
bhreugs = Obst
bhreugsmṇ = Weizen
bhreugtis = Verwendung
bhreukō = Streik
bhrēunā = Grenze
bhreusō = schwellen
bhrēwā = Brücke
bhrewō = brauen
bhrewṛ = gut
bhṛghos = hoch
bhrigijō = zwitschern
bhrijājō = krümeln
bhṛijō = aufschneiden
bhríkāmi = drücken
bhṛkjō = Zeug
bhṛksnos = Esche
bhṛktos = gesprenkelt
bhṛmā = Einschnitt
bhrṇgō = Pause
bhroigos = Gipfel
bhrosdhos = Zeder
bhrounóm = Maßstab
bhrounos = braun
bhroustom = Fragment
bhrówṇtis = Stirn
bhṛstís = Spitze
bhṛtis = Lager
bhrughnos = Rohrkolben
bhrūgjai = Verwendung
bhṛugs = Kehle
bhrūs = Augenbraue
bhrúsnāmi = Pause
bhrusnjā = Kürass
bhrusos = Brust
bhrustóm = Teilchen
bhrutēks = Busch
bhrwtom = Sirup
bhudhmṇ = Boden
bhudhnos = Boden
bhugjō = fliehen
bhugos = Tier
bhukús = stumpf
bhuljā́ = Schwellung
bhulkos = Wächter
bhūm = wurde
bhúncai = dienen
bhusājō = Kuss
bhūsjō = beschleunigen
bhūtā́ = Wohnung
bhutjō = Hit
bhūtós = worden
bh∂skō = aussprechen
bh∂tjō = Hit
bh∂wējō = günstig-sein
bistlis = Galle
blaktā = Küchenschabe
blatsājō = Geplapper
blēkājō = blöken
bṇdus = Tropfen
bodhrós = taub
bokkos = Ziege
bólboljō = explodieren
bolkos = Tunnel
boukājō = erklingen
brenghos = rau
brokos = Dachs
bughōn = Uhu
bukkā = Schluck
cadhō = Tauchgang
cāmṇ = Schritt
cécālos = banal
cedhō = Qual
cejwō = leben
cēlejō = Folter
célṇdis = Eichel
celō = wegwerfen
celom = Hohlraum
célwonom = Badewanne
cemjō = kommen
cenā = Frau
cerbhō = verschlingen
ceri = Berg
cerjō = Finish
cerō = Lob
cerō = Fieber
ceru = Hecht
cérurom = Brunnenkresse
césneumi = auslöschen
cespis = Niederlassungen
cetus = Harz
ceudhos = Müll
chaisos = schön
chedhō = beten
cheldi = Galle
chelō = Wunsch
chendō = Wunde
chenmi = Mord
chentis = Tod
cherō = warm
cheros = Wärme
chislom = Draht
chḷnō = täuschen
chōks = Fackel
chonós = reichlich
chormos = warm
chornos = Herd
chrensós = Wärme
chṛjō = gewalttätig-sein
cícāmi = weggehen
cijā = falten
cínāmi = herrschen
cīrós = üppig
cistis = Finger
cītā = Leben
cīwāks = lebhaft
cīwos = Leben
cīwós = lebendig
cīwotos = Tier
cḷā = Speiseröhre
cḷājō = fliegen
cḷēnós = müde
cḷnāmi = quälen
cḷturós = Geier
cṃtis = März
cobhōn = Viskose
coinos = Sack
colbhos = Gebärmutter
corós = großer-Esser
cosdhos = Stange
cotejō = erwähnen
cotlós = Schwellung
coucis = Scheiße
coudhros = schmutzig
cówijā = Kiebitz
cowijós = Rinder
cówqolos = Hirt
cows = Kuh
cowstā́s = Ochsen-Stall
cṛ(āw)ús = schwer
cṛājō = verschlingen
crātós = willkommen
cṛā́wenus = Mühlstein
cṛcestjom = Bruchbude
cṛcots = Wirbel
cṛebhos = Embryons
creughos = traurig
croghos = Adamsapfel
crotsos = groß
croughnos = Trauer
cṛús = Kran
cr∂tos = schwer
dā = sicherlich
daimoi = aufteilen
daitis = Zeit
daiwēr = Schwager
dakru = Träne
dāmos = Kumpel
dānus = Fluss
dápnāmi = teuer-sein
dapnom = Fest
daps = Bankett
dáwētā = Fackel
dáwetus = Feuersbrunst
dáwneumi = versengen
dawtis = Kraftstoff
dē = von-oben
debhō = kneten
dedrus = Allergie
deghā = Zecke
deikm∂n = Beispiel
deikō = zeigen
deikos = Adresse
deiktis = Anzeige
deiwā = Göttin
déiwijos = fromm
deiwos = Gott
deiwotāts = Gottheit
deiwots = reich
dekējō = werden-angemessene
dekṃ = zehn
dékṃtulos = Finger
deknos = würdig
dekos = Tugend
déksteros = Recht
deljō = berechnen
delō = Split
demos = Gebäude
denkō = Biss
densō = infere
dentis = Zahn
derbhō = drehen
derghō = erhalten kumuliert
derō = trennen
deru = Holz
deukō = ziehen
deuks = Führer
deusō = verderben
dew = weit
dhabhros = geschickt
dhalnā = Vegetation
dhanwos = Tannenbaum
dhaunos = Raubtier
dhchínāmi = verschwinden
dhchitis = Zerstörung
dhebhō = Missbrauch
dhechō = brennen
dhēdhjos = Großvater
dhedhmós = Dekret
dheghom = Erde
dheghwis = Entzündung
dheicō = Einstich
dhéicodhlā = Brosche
dheimi = saugen
dhejō = setzen
dhēlēiks = produktiv
dhēlgs = Sense
dhēljos = Baby
dhelō = Glanz
dhēlós = Zitze
dhēmṇ = Bedingung
dhemō = Dampf-bis
dhenghō = drücken
dhēnom = Agrarprodukt
dhēnos = Interesse
dherbhō = Start
dherghnos = Schlehe
dherghō = stärken
dherghos = rot
dherghs = Scheiße
dherkō = Fleck
dhermi = behalten
dhēs = Pflicht
dhētis = Tatsache
dheughō = ausreichen
dheukō = zerstören
dheunos = Tod
dhewō = laufen
dhḗmonā = weiblich
dhghjesi = gestern
dhghomōn = Mensch
dhghusā = Barsch
dhicsnis = Ende
dhídhēmi-dh∂kjō = tun
dhinghō = Modell
dhḷeghlā = Schulden
dhṃelós = Stiftung
dhṃis = Hunger
dhṃos = Mitarbeiter
dhṇghus = direkte
dhobos = solide
dhochejō = heiß-machen
dhochos = Tag
dhoighos = Wand
dholos = hohl
dhombhos = Taube
dhōmós = Meinung
dhōnā = Getreide
dhóncelos = dunkel
dhoncos = dunkel
dhónejā = hohl
dhontis = Brunnen
dhorjā = Durchfall
dhoubhos = taub
dhoubhús = schwarz
dhoubnom = Welt
dhoulis = Ruß
dhōunis = strick
dhraghō = herausbringen
dhreghō = herumlaufen
dhrēnos = brüllen
dhrensājō = Schrei
dhreughō = Wehrdienst
dhrighsós = Bündel
dhṛmos = stetig
dhṛnumoi = Sprung
dhroghnom = Töpfer-Rad
dhroghós = Rad
dhṛsō = wagen
dhṛstis = Kühnheit
dhṛsus = fett
dhrubhjō = krümeln
dhrubhtis = Tropfen
dhruslijō = demontieren
dhubús = tief
dhugtēr = Tochter
dhūmājō = Rauch
dhūmós = Rauch
dhúneumi = agitieren
dhuskos = dunkel
dhwerō = täuschen
dhwestus = fleabane
dhwolnos = verrückt
dhwolsā = Whirlpool
dhwonos = Ton
dhworis = Tür
dhworom = Hof
dhwosos = Dämon
dh∂tis = Erschöpfung
dídēmi = Krawatte
dídjāmi = konzipieren
didkskō = lernen
dighā = Ziege
djejō = bewegen
djēws = Tag
djnos = Tag
dḷghējō = halten
dḷkus = süß
dḷnghos = lang
dḷnghotā = Länge
dṃpedom = Bauort
dṃpus = rau
dṃseghṛ = Domain
dṇghwā = Zunge
dṇsus = dick
dō = auf
dokejō = scheinen
doklom = Schwanz
dolājō = cudge
dolejō = stören
dolghos = Tau
dōljom = Lauf
dolos = Betrug
dom = noch
dómāmi = zahm
domos = Haus
dómūnā = Wirtin
dómūnos = Vermieter
dōnom = Geschenk
dornom = Handgelenk
doros = Miete
dōsos = Sklave
dōtis = Mitgift
dounom = Stadt
dousmos = Busch
dóusontos = Arm
drājō = Arbeit
drappos = Gewandung
drātis = Arbeit
drātṓr = Arbeiter
dṛdrājō = Murmeln
dremō (dídrāmi) = laufen
drepō = ausschneiden
dreughō = betören
drewā = Natürlich
drewō = behandeln
drismós = hart
dristos = Brombeere
dṛkjai peri = sichtbar-sein
dṛkjō = bilden
dṛkō = siehe
dṛkos = Vision
dṛksmos = Perspektive
dṛktā = Licht
dṛktis = gesehen
dṛktis = Blick
dṛmijō = einschlafen
dṛnós = Split
dṛtis = Split
dṛtós = Split
dṛwā = Weidelgras
dsā = Krieg
dumbos = Schwanz
dúnāmi = liegt
dus = schlecht
dúsōpis = prekär
duswids = inkompetent
dweimi = Angst
dwenos = gut
dwidkṃtói = zwanzig
dwipods = zweibeinig
dwīs = zweimal
dwīskos = Matching
dwīsnōs = je-zwei
dwoiros = ängstlich
dwoplos = Doppel
dwóteros = zweite
dwou, dwāu, dwou = zwei
ēchṛ = trinken
ēchṛjos = betrunken
ecnis = Feuer
edhlos = Holunder
edhṛ = Palisade
edjēw = heute
edmi = essen
edqis, edqid = jemand
edqos, -qā, -qod = einige
edunā = Schmerz
egējō = Mangel
eghjos = Igel
eghṛ  = Grenze
egō = Ich
ei = dass
eibhō = bumsen
eikō = haben
eimi = gehen
eisā = Zorn
eisāskai = böse-sein
eisom = Eis
ek(sí) = außerhalb
eksoqs = unsichtbar
ekstar = Abgelegenheit
éksteros = externe
ékstṃos = äußerste
ektós = vorbehalten
ekwā = Stute
ekwīnós = von-Pferden
ekwos = Pferd
ēlā = Ahle
elēn = Rotwild
elkós = schlecht
elkos = Wunde
ellus = Aal
elne elnā elnod = dass
elóm = durchgeführt
elōr = Schwan
elwos = rosa
emō = nehmen
empis = Insekt
en = in
endo = innen
endósēdjom = Möbel
enim = und
enīqā = Gesicht
enis = bestimmte
enkō prō = Antrieb
ennós = Innenraum
énsēdjom = Hinterhalt
enslā = Insel
enstar = Nähe
énteri = zwischen
énternos = interne
énterom = Intervall
énteros = interne
énteros = Darm
entós = innen
éperom = Westen
epi = auf
épiromos = oben
ercom = Puls
erjos = rammen
erkō = Aktie
ermi = Rest
ermos = aufgegeben
ernos = aufrecht
erō = heben
éroros = Adler
erqō = Glanz
ersā = Schwanz
ersábhaljom = Schwanz
ersājō = wandern
erwā = Land
esmi = werden
ēsmoi = befinden
esos = Erzieher
esṛ = Blut
ēsús = gut
éteros = zweite
eti = auch
étiqe = auch
etmṇ = Seele
ētṛ = innen
ētros = lebendig
eukō = verwendet-werden
eusō = brennen
ewō = sich-anziehen
extrōd = von
ḗpijos = Beziehung
gálgaljō = Diskussion
galnos = Gallien
galnos = Macht
gangō = festzunageln
gar = ja
garsijō = Diskussion
gāudhējō = jubeln
gaudhjom = Freude
ge = mindestens
geigō = bitter-sein
geimō = sprießen
geisā = Kies
geltis = Embryo
gelu = Eis
gemō = geladen-werden
gemros = Schwiegersohn
genesājō = schaffen
gengā = Kaugummi
genjos = Geschlecht
genmṇ = Keim
genos = Verwandtschaft
gentis = Familie
gentlom = Geburt
gentṓr = Eltern
gentrīks = Eltern
gentus = Fortpflanzung
genu = Knie
genus = Oberkiefer
gercō = sammeln
gergō = Wind
gerjō = aufwachen
gerlós = alt
gerō = alt-geworden
gersā = Netzwerk
gerwós = Veteran
gesō = Verschleiß
geulom = Asche
geustis = Geschmack
gewō = erklingen
ghabhlom = Gabel
ghabhros = Ziege
ghaidīnós = goatish
ghaidos = Ziege
ghaisējō = Stick
ghaisom = Speer
ghaisom = Stick
ghaitā = Haar
ghálerom = Schande
ghanos = Gähnen
ghansōr = Goos
ghastā = Spießschaft
ghawō = Anruf
ghawōd = nicht
ghebhlā = Kopf
ghedō = koten
ghei-ke ghāi-ke ghod-ke = dieser
gheidhō = lang
ghéimentos = winterlich
gheimṛ = Winter
gheimrīnós = winterlich
gheipō = schluchzen
gheislos = Geisel
ghelbō = prahlen
ghelijō = Knurren
ghelnom = Lippe
ghelō = einschneiden
ghelus = Schildkröte
ghelwos = Gemüse
ghelwos = grün
ghēmi = ankommen
ghenghō = Schritt
ghēr = Igel
gherdhō = einkreisen
gherghros = Schote
gherijai = Wunsch
gherō = verleihen
ghertom = Butter
gherús = klein
ghesṛ = Hand
ghesris = Handschuh
ghestos = Hand
ghētis = Ankunft
ghetlā = Griff
gheughō = Schleier
gheusō = hören
gheutis = Schimmel
gheutlom = Vase
ghéwejā = hohl
ghewos = Raum
ghi = sicherlich
ghighējō = zurückkommen
ghirrijō = jammern
ghjājō = gaffen
ghjems = Winter
ghlaghos = Querbalken
ghlastos = blau
ghlendhō = Studie
ghleumi = Witz
ghloidos = Luxus
ghlōmi = Schimmer
ghloumos = Witz
ghḷtnós = golden
ghḷtom = Gold
ghlustis = blühend
ghṇdhus = Krebs
ghṇdō = erhalten
ghneumi = Liebkosung
ghodos = Hinterteil
ghoilos = freudig
gholwā = caluum-caput
ghórdejom = Gerste
ghordhos = Gehäuse
ghorejai = fördern
ghornim = angenehm
ghoros = Darm
ghorsejō = aufrecht
ghortos = Garten
ghosdos = Hunger
ghosóm = aß
ghóstipots = Gast
ghostis = Ausländer
ghouros = schrecklich
ghowejō = achten
ghradjai = Schritt
ghrāsmṇ = Gras
ghrāsom = Gras
ghrebhō = begraben
ghrēdhus = Hunger
ghreibhō = beschlagnahmen
ghreim∂n = Salbe
ghṛējō = leer-sein
ghremō = schimpfen
ghrendhā = Gesims
ghrendhos = Sperre
ghrendō = nagen
ghrēw = früh
ghrewō = fallen
ghrewō = mahlen
ghromos = brüllend
ghronos = Marke
ghroudos = Kugel
ghrowā = Kiesel
ghudjō = schaden
ghundō = gießen
ghwerā = Tier
ghwērīnós = gemein
ghwērós = wild
ghwobhros = Schmied
gh∂bhējō = eigene 
gh∂rtā = Spitze
gibbā = Buckel
gígisai = passieren
gignō = zeugen
gigrós = scharf
gjewō = kauen
glabhō = Flugzeug
gladhros = auch
glaghā́ = Protest
glakti = Milch
glegos = fügsam
gleibhō = haften
gleis = Maus
glēkis = intelligent
glembhō = umfassen
gleubhō = schälen
glínāmi = Stick
globhos = Globus
glōghis = Punkt
gloidos = Gummi
gloijós = klebrig
gloitṇ  = Leim
glokijō = Klappern
glomos = Garn
glōs = Schwägerin
glujō = schlucken
gl∂gjēs = Eis
gnājō = produzieren
gnāmi = nagen
gnās = Nachkommen
gnāskai = geboren werden
gnātós = geboren
gnebhis = Vlies
gnebhō = zupfen
gneibhō = schleifen
gneichō = mager
gneidō = schaben
gnōros = offensichtlich
gnos = nativen
gnōsmi = erkennen
gnōtis = Wissen
gnōtlom = Anmelden
gnōtós = bekannt
gnōtṓr = Wissende
gnoubhos = Knospe
gnōwos = weise
golbhnos = Dart
gombhos = Rachen
gomos = Last
gonējō = produzieren
gopos = Rachen
gorbos = Falte
gorgnóm = Traurigkeit
gorgós = traurig
goulos = mündliche
gouros = gekräuseltes-Haar
grakijō = gackern
grammā = Rheum
grānom = Korn
gṛbeinos = Hainbuche
gṛbējō = Falten-haben
gṛbhō = Kratzer
grebhos = net
gredō = Kratzer
gregs = Herde
gremjom = Runde
grendjom = Krone
gretlom = Wiege
greubhō = beiseite-gehen
greugō = Biegung
greumō = abkratzen
greutō = verfestigen
grṇdhís = gewachsen
grōbhos = Eiche
grōdis = Hagel
groumos = Krume
grundijō = grunzen
grutis = Quark
gudom = Eingeweide
gugā = Kugel
gupā = Keller
gurnos = zurück
gusnō = Geschmack
gutṛ = Kehle
idhei = es
ikjō = erreichen
ili = Leiste
īljō = wegschicken
imde = von-dort
immō = mehr
ipjō = bedrücken
is, id = dieser
īsarnom = Eisen
ita = so
itājō = Reise
itaqe = und
íteros = unterschiedliche
itim = ebenfalls
itṛ = Weg
iwe = wie
ī́nekmi = vermitteln
jagjō = Gottesdienst
jāgjus = fromm
jāi = ja
jālos = Verschwörung
jāmi = Pass
jāmi = bereits
jáneumi = konspirieren
jā́nuwā = Eingang
jeghō = verfolgen
jegis = Eis
jekō = sagen
jekos = gesund
jēlom = Wüste
jemō = halten
jemós = Zwilling
jentēr = Vetter
jeqṛ = Leber
jesō = Ferment
jeunis = richtige-Weg
jeus = Brühe
jewesdiks = Richter
jewō = Hilfe
jewom = Gerste
jéwornjom = Getreide
jewos = Gesetz
jṇdros = überschwänglich
jṇtō = Wunsch
jod qid = weil
jodhei = wo
joinkos = Rohrkolben
jom = wenn
jomde = aus-denen
joqe = und
jori = warum
jorkos = Rehbock
jōrom = Saison
jōrós = Verschwörer
jos (je), jā, jod = dass
jṓsneumi = begird
jota = wie
jota sei = gleichermaßen
jóugsmṇtom = buden-Lasttier
jówestos = nur
jucis = ewig
judhejō = Befehl
jugóm = Joch
jungō = beitreten
júwenis = jungen
juwes / juwe = Sie
juwṇkós = jungen
júwṇtā = Jugend
juwōn = jungen
j∂kējō = werfen
j∂kjō = auswerfen
ka = sicherlich
kábṇlos = Fohlen
kabōn = Pferd
kadhō = halten
kadō = Herbst
kādos = Ärger
kadros = Heilige
kaghlā = Eröffnung
kaghos = Gehäuse
kaidō = Schnitt
kaikos = blind
kailom = Augur
kaipā = Zwiebel
kairós = unangetastet
káisṛjēs = lange-Haare
kaisrom = Haar
kaitom = Heide
káiwelos = ausschließlichen
kákabā = Rebhuhn
kakkājō = koten
kaklājō = gackern
kákneumi = fördern
kakō = thinnen
kaldējō = erlebt-sein
kaldos = Blase
kalēiks = Tasse
kalgōn = Nebel
kālis = Ort
kalkis = Ferse
kalwos = kahl
kambos = gebogen
kāmi = Liebe
kamō = drücken
kampos = Land
kánāmi = graben
kandō = Glut
kánkestos = Fohlen
kankus = Zweig
kanmā = Bein
kanmṇ = Song
kanō = singen
kantos = Felge
kaplos = Werkzeug
kāpos = Land
kaprā = Ziege
kapros = Ziege
kaput = Kopf
kareinā = Kiel
karkar = Anreicherung
kárkarjō = ankündigen
karkros = Krabbe
karnājō = festzunageln
karōn = Glied
kāros = Geliebte
karpō = sammeln
kárrēkā = Rock
kartús = hart
kasnos = grau
kasterlom = Burg
kastra = Lager
kastrājō = Pflaume
kastrom = Schere
katēsna = Kette
katsājai = treffen
katsājō = sammeln
kattā = Katze
katus = Kampf
kaukos = Schiff
kaulis = Kohl
kaunós = beschämend
kawdō = Hit
kawō = Hit
káwonā = Eule
ke = von-hier
ke kā kod (eke ekā ekod) = dieser
kei = hier
keidō = gehen
keimēx = Bug
keimoi = Lüge
keimos = Farbstoff
keiros = dunkel
kéiwijos = Zivil-
keiwis = Bürger
kekājō = binden
kekātrīks = Narbe
kekō = Sprung
kékuros = zahm
kēlā = Kammer
kēlājō = verstecken
keldō = Streik
kelgā = Geheimnis
kéliknom = Penthouse
kelmos = Helm
kelō = Push
kélodhros = Schlange
kēlom = Pfeil
kelos = Deckel
kelots = Junge
kelsō = hoch-sein
kelujō = Reisen
kelus = Straße
kémelom = Himmel
kémeros = Lotus
kemjō = Brummen
kemō = Stamm
kemos = hornlos
kenēs = Asche
kenkai = zögern
kenklom = Sehne
kenkō = wiegen
kenkos = Haken
kenō = entstehen
kentom = Lappen
kentrom = stechen
kepō = schaden
keqō = schmutzig
kérberos = Wiesel
kerdhjos = Hirt
kerdhō = Bereich
kerdhos = Gruppe
kerdos = Beruf
kerkō = abmagern
kerkos = Henne
kernos = Bagger
kernós = gefrorene-Schnee
kerom = Haar
kersnā = Abendessen
kersō = verstümmeln
kersṛ = Kopf
kerwos = Hirsch
ker∂srom = Gehirn
kesdō = withraw
kēsmi = zurückhalten
kesnus = Knoblauch
kesō = Kamm
kētjā = Zimmer
keubō = Kurve
keudhō = verstecken
keukō = Kette
keulom = Schwellung
keusō = Miete
kēwējō = wiegen
khákhatnos = Lachen
khamos = Haken
khéderos = Efeu
kighrós = aufgeregt
kikēr = Erbse
kikjā = Specht
kiklēskō = aufrufen
kiklós = Kälte
kíkōnjā = Storch
kīkus = Muskel
kina = von-dieser-Seite
kingō = gürten
kintos = vorhergehenden
kippos = PEG
kirknos = Zirkel
kirkos = Kreis
kiskā = Bizeps
kistā = Korb
kíteros = von-dieser-Seite
kitōd = sofort
kitrōd = in-dieser-Richtung
kiwos = Farbe
kī́keumi = kräftig-werden
kjājō = sortieren
kjējō = aktivieren
klādis = Schaden
kladjos = Schwert
klagjō = Klirren
klāmājō = schreien
klambós = verstümmelten
klāmi = eindämmen
klamrós = schwach
klārós = laut
klāros = Tablette
klāstis = Einberufung
klaudos = lahm
klawdō = schließen
klawos = Nagel
klāws = Schlüssel
klawstós = geschlossen
kḷdis = Bergpfad
kḷdos = Holz
kleinos = Ahorn
kleitis = Hütte
kleitrom = Unterstützung
kḷējō = heiß-sein
kḷējō = Name
klepō = stehlen
kleumi = hören
kleumṇ = Anhörung
kléumṇtom = Ruf
kleusō = gehorchen
kleustis = Gehorsam
kleutis = Hörer
kleutō = Verlosung
kleutrom = Geschichte
klewō = waschen
klewos = Ruhm
klínāmi = Hang
klisrós = sanft
kḷjō = Kluft
kḷneumi = hören
klṇgō = Ton
kloiwos = steil
klopnis = Tal
klounis = Pobacke
kḷpros = Weinfass
kḷtos = heiß
klūtós = berühmt
kluwējō = bennant-werden
kḷwijō = diffamieren
kmāmi = müde
kṃertos = Hummer
kṃros = gekrümmten
kṃti = mit
kṃtom = hundert
knakos = Gelb
kṇjós = der-letzte
knokos = Hals
knouks = Mutter
kṇsējō = opinate
kṇstṓr = Sprecher
knuwā = Nussbaum
kobom = Erfolg
kodējō = thurify
koilús = gesund
kóilutāts = Gesundheit
koimā = Vereinbarung
koimos = schön
koinos = foenum
koinós = verwandt
koisā = Beruf
koitús = Weise
koksā = Hüfte
koksednīks = Hüftknochen
kolignos = Hund
koljō = Stick
kolmṇ = Gipfel
kolmos = Stengel
kolnis = Hügel
kolnom = Haufen
kolnos = einäugig
kolsos = Hals
kólumbhos = Taube
kom = mit
kómāglom = Sammlung
kómjougos = Gewerkschaft
komjugs = Gemahlin
kómmoinis = gemeinsame
kommoinitā́ts = Gemeinde
komnom = Sitzung
kómnōmṇ = Nachname
kómopjom = Ausrüstung
kōmos = Masse
kómplēnos = Ergänzen
kómsqṛtos = perfekt
kómtḷtis = Geduld
komtrōd = gegen
kómwoirjom = Gericht
kómwoistis = Gewissen
kōnājai = versuchen
konkejō = brennen
konkhā = Schale
kōnos = oben
kophos = Huf
kopnos = Oase
kóqros = Schmutz
korbhis = Korb
koris = acarian
korjom = Leder
korjos = Armee
korkos = Schlamm
kormnos = Bleichmittel
kormōn = Hermelin
kormos = Schmerz
kornīks = Krähe
kornos = Kirschbaum
kṓrukos = Beutel
korwos = Rabe
kósolos = Hasel
kostā = Rippe
koubos = Joint
koupā = Tasse
koupnā = viel
koutā = Hütte
kowos = hohl
kowṛ = Höhle
krāmi = mix
krasi = morgen
krāsrōn = Hummel
krātis = Netzwerk
kratsos = rundlich
kṛdḗn = Scharnier
kṛdhōn = Kohlenstoff
kṛdi / kṛdjom = Herz
kṛdijai = wütend
kṛdjō = Rock
kṛdsus = T-Shirt
kréddhēmi = glauben
kreidhrom = Sieb
kreimṇ = Kriminalität
kreitsō = schütteln
krekō = weben
kremājō = brennen
krēmi = schaffen
kremom = Bier
krémusom = Zwiebel
krenghos = Ring
krenktis = Narbe
krépāmi = knistern
krepō = Niederschlag
krepús = stark
krēqā = Grenze
krēskō = wachsen
krētā = Kreide
kretō = Schnitt
kreugō = Schrei
kreuks = Kreuz
kreumi = Lager
kreupō = verkrustet
kreutō = agitieren
krēwō = Touch
krigā = Schrei
krinō = Sieb
kripsnis = Mähne
kripsos = lockig
kripstā = Kamm
kristājō = Shuttle
kritis = Unterschied
kṛjēs = rot
kṛklos = schlank
kṛnāmi = rot
kṛnos = morsch
kṛnu  = Horn
krōbhtus = Hingabe
krokijō = Schrei
kroknos = Anorak
krotjājō = schütteln
krous = Bein
krowos = Obdach
kṛpjos = Schuh
kṛpos = Körper
kṛsējō = zerkratzt-werden
kṛsnos = schwarz
kṛsō = laufen
kṛstus = Natürlich
kṛsus = Einkaufswagen
krustā = Eiszapfen
krūtis = Kuppel
kruwós = Blut
kṛwos = gekrümmten
ksentis = Dornbusch
kserós = trocken
ksnowātlā = Rasiermesser
ksnujō = Rasur
ksūlom = Beitrag
kúbāmi = Lüge
kudājō = tadeln
kukulājō = cockoo
kukūlós = cockoo
kūlā = Versteck
kūleks = Mücke
kūlos = Esel
kumbhā = Topf
kumbō = zurücklehnen
kūmós = Haufen
kúnejos = Keil
kupjō = Nachfrage
kurnos = Fohlen
kusdhos = Schatz
kusis = Kuss
kūtis = Haut
kuwējō = schwanger-sein
kuwos = Welpe
kúwṛos  = mächtig
kwāimi = erwerben
kwatsos = Käse
kweidos = Weiß
kwōn = Hund
k∂pjō = Fang
k∂psā = Box
k∂ptos  = gefangen
k∂sējō = Mangel
k∂stos = rein
k∂tos = scharf
k∂wējō = Vorsicht
labhō = nehmen
laghā = Spaten
lāgō = sinken
laiwos = links
lājō = schelten
lajos = Fett
lakertos = Unterarm
lakus = See
lalājo = Geplapper
lalu = Penis
lāmā = Pudel
landhom = Bratpfanne
lāōs = gott 
lāpos = Kuh
lapsā = Lampe
latēks = Flüssigkeit
latom = Tag
lāurā = Mauerwerk
lawō = Nutzen
lāwós = Team
lawtlom = Nutzen
lā́mṇtom = aussagen
ledō = Freigabe
leghō = Lüge
leghos = legen
leghskā = Siedlung
leghskós = faul
leghtrom = Unterstützung
leghús = Licht
légneumi = auswringen
legō = sammeln
legs = Gesetz
leibs = Tropfen
leidmi = erlauben
leiglā = Löffel
leigō = Sprung
leiljom = Lilie
leinō = vermeiden
leinom = Flachs
leipā = Linde
leisā = Parterre
leitō = gehen
leitos = Meer
lembō = hängen
lēmi = Zuschuss
lemō = aufbrechen
lemsos = Phantom
lendhā = Frühling
lenghmi = erklären
lēnis  = schwach
lentos = Wacholder
lepō = stottern
lergos = Wohnung
lēsanks = Schiefer
lesō = Pick
leswos = mittelmäßig
lētis = Konzession
letrom = Leder
leubhos = liebe
léudheros = frei
leughō = Lüge
leukō = Glanz
leukós = hell
leuks = Licht
leuksmṇ = Licht
lēumi = Schaden
leups = Blatt
lewis = Sichel
ligājō = binden
likējō = dürfen
limpō = Stick
linghō = lecken
līnō = Salben
līnós = ointed
linqō = verlassen
lipējō = geklebt-werden
lippā = Rheum
liprós = fettig
litājō = beschwichtigen
litwos = Stange
lṃbō = Schluck
lṇcō = Reifen
lṇghros = Licht
lōbā = Kriminalität
lodi = spät
loghējō = legen
loghjom = Website
loghos = Anzahlung
loigós = Armut
loigos = Kalb
loimos = Schlamm
loiqnom = verleihen
loiqós = verbleibenden
loisā = Tablette
loisós = mild
loksós = schräg
loksos = lax
loktos = Fehler
londhom = Land
londhwos = Hüfte
longhros = Wurm
lordós = verdreht
lorgā = Fußabdruck
lorgos = Verein
lostos = Speer
loudis = Lob
loughjom = Eid
lougos = Zweig
loukejō = beleuchten
loukētjos = strahlend
loukos = Lichtung
loukós = Glanz
louksā = Fenster
louksnā = Mond
louksos = Luchs
lousēn = Laus
loutsā = Hure
lowā = Haar
lowō = waschen
lowtrom = Bad
lubhējō = wie
lubhjā = Kraut
lubhros = Bast
ludhóm = ging
lugējō = gebrochen-werden
lugjā = Loch
lugnós = flexibel
lugtos = Vielzahl
lukējō = Glanz
lukskējō = aufleuchten
lúnāmi = Split
lūnós = ungebunden
lutom = Schmutz
lūtós = ungebunden
luwō (lewō) = lösen
luwō apó = freisprechen
l∂bjom = Lippe
l∂kesājō = Träne
l∂kjō = Falle
l∂kós = Reißen
l∂nchijóm = Lunge
l∂pējō = flach-sein
l∂pods = Stein
l∂skējō = Phantasie
l∂tējō = verschwiegen-sein
machos = Junge
machotis = Jugend
mághneumi = verteidigen
maghos = Feld
magō = Form
mājō = gedeihen
mākājō = Grube
makēn = Beutel
mākesjā = Wand
makrós = schlank
mammā = Mama
mān = so
mānājō = Frühling
mánnusos = Mann
mānos = gut
maqā = Mädchen
maqos = Junge
máreskos = Sumpf
margōn = Grenze
mari = Meer
markos = Pferd
masdos = Mast
mātējō = benennen
mātḗr = Mutter
māterós = solide
mātérterā = Tante
matlā = Hammer
mauros = düster
mā́kōn = Mohn
ṃbhros = Sturm
mē = nicht
me = mir
medai = nachdenken
medgós = Möwe
médhidjōws = Mittag
medhjos = Mitte
medhu = Met
medjom = Eichel
médneumi = verwalten
médodiks = Arzt
mēdos = Bewertung
meicō = bewegen
meidō = auskratzen
meidos = Prestige
meilēts = Krieger
meinom = Zweck
meitō = Mangel
meitrom = Vereinbarung
meiwijós = kleiner
mejājō = Fluss
mejnō = Unter
mejō = Austausch
mejtis = Verschiebung
mēknos = Lippe
meldhjā = Donnerkeil
meldhō = beten
melit = Honig
meljom = Hirse
melkō = reiben
melmṇ = Artikel
melō = mahlen
melos = stark
melsō = täuschen
melwom = Mehl
membhō = bestrafen
mēmi = Maßnahme
mēmsóm = Fleisch
mendhai = interessiert-sein
mendhō = schüren
mendō = saugen
mendom = Fehler
menghos = häufig
mengō = Verkleidung
menis = Weißfisch
menmṇ = Intellekt
menos = Sinn
mēnsis = Monat
mentā = Stange
mēqos = Moment
mercō = schwarz-machen
mergā = Gabel
merghā = Schlinge
mergis = Dreck
mergō = Waschbecken
merkēds = Ladung
merkō = flimmer
mérneumi = Sorgen
meros = einfache
mersō = Block
merwos = fade
mesgō = kommunizieren
meslā = Amsel
mestis = Maßnahme
mestós = gemessen
mētā = Beitrag
meti = in-der-Mitte
mētijai = Maßnahme
mētis = Dimension
metō = ernten
metrom = Maßnahme
meudos = stolz
meugō = betrügen
meukō = Kratzer
meus / muskós = Muskel
ṃgadhós = prachtvollen
mighlā = Nebel
míkāmi = flimmer
miljom = Rötel
mimdō = treffen
mímnāskō (memna) = erinnern
míneumi = reduzieren
minghō = pissen
mínusi = weniger
misdhom = Gehalt
misgā = Molke
miskejō = mix
mlājō = schwächen
mlākós = dumm
mlātóm = Mehl
mḷdhos = permissiv
mḷdsnos = erweicht
mḷdus = weich
mḷduwijō = aufweichen
mḷgājō = ankündigen
mlīnós = schlaff
mḷjos = 
mḷkāmi = schwächen
mḷnos = dunkel
mlōdhrós = hoch
mlōskō = erscheinen
mḷsos = langsam
mḷwā = Malve
mṇdōmi = verpflichten
mṇējō = bleiben
mṇijai = Turm
mṇjō = betrachten
mṇkos = defekt
mṇkstrom = Shaker
mṇsjai = beabsichtigen
mṇtijai = setzen
mṇtis = Geist
mṇtō = kauen
mṇtom = Kinn
mṇtos = erwähnen
mṇtrājō = wischen
mṇus = Hand
mṇwos = dürftig
mō = aber
modos = Maßnahme
mōdos = Ausdauer
moghjos = angenehm
moghō = können
moghtis = könnte
moghtrom = Mittel
moighos = pinkeln
moilos = mild
moinijai = stärken
moinis = verpflichtet
moinja = Wände
moisos = Schafe-Haut
moitājō = Austausch
moitmos = Dank
moitwos = gegenseitige
mojnos = Austausch
moksi = bald
molā = Mühlstein
moldhā = okzipitalen
moldhos = Gebet
moleinā = Mühle
mōlestos = ärgerlich
molgējō = Milch
mōlis = Masse
moljā = Küste
mōlos = Aufwand
molpā = Stolz
molqos = nass
moltlom = Hammer
mondō = schmücken
mondós = Welpe
monejō = warnen
mongos = Hals
monīli = Kragen
monos = Hals
montis = Hügel
morā = Verzögerung
morā = Albtraum
morcós = dunkel
mordējō = Biss
morignā = Frau
morjods = Schenkel
mórmoros = Panik
morom = Beere
mōrós = dumm
mōros = renommierten
moros = Todesfall
mōs = Charakter
mosgom = Kleinhirn
moukos = Schleim
mouros = Schmutzwasser
mousos = Unkraut
moutos = Penis
mowejō = bewegen
mreghmós = Schädel
mṛējō = verdienen
mṛghús = kurz
mṛijai = sterben
mṛjos = pubertierenden
mṛkā = Karotte
mṛkējō = welk-werden
mṛkos = Behinderte
mṛktos = gesprenkelt
mṛmeikā = Ameise
mṛmrājō = Murmeln
mṛtājō = zermalmen
mṛtāsjom = Mörtel
mṛtis = Tod
mṛtos = tot
mṛwos = tot
mūdlom = Waschmittel
mūdnós = sauber
mudstos = muss
mugijō = muhen
munkō = auspusten
mūs = Maus
muskā = fliegen
muskos = Moos
músnāmi = absondern
mūtrom = Schlamm
muttijō = murmeln
muttis = sprachlos
m∂dējō = nass-sein
m∂gis = mehr
m∂glos = edel
m∂gnán∂mos = großmütig
m∂gnos = groß
m∂gtājō = Ehre
m∂rnamói = Plünderung
ṇ = un
nantis = Mut
nāsis = Nase
natrīks = Schlange
nawāgós = Seemann
nāws = Schiff
ṇbhudhnóm = Abgrund
ṇcḗn = Leiste
ṇdha = dann
ṇdherós = liegend
ṇdhētós = ungemacht
ṇdhi = mehr
ṇdwojos = aufrichtig
nē = keine
nebhis = Wolke
nebhlā = Nebel
nedis = Nessel
nedjos = in-der-Nähe
nedō = Link
nedsā = net
nedskō = binden
neghō = eindringen
neghrōn = Niere
nei = überhaupt-nicht
neicō = waschen
neidō = demütigen
neikō = worfeln
neitom = Rivalität
neiwós = deprimiert
nékāmi = töten
nekopīnós = unerwartete
neks = Tod
némētom = Heiligtum
nemō = verteilen
nemos = Wald
nemots = Feind
nepēts = Enkel
neptis = Enkelin
neqe = und-nicht
neqid = nichts
neqis = niemand
neqom = nie
neqos = jemand
neros = Soldat
nérteros = niedriger
nertos = stark
nesros = bescheiden
ṇeu = ohne
neudō = verbringen
neukos = Kurzsichtige
new(ij)os = neue
newājō = erneuern
newṇ = neun
néwṇos = neunte
newō = Nicken
newotāts = Neuheit
ṇgnōtós = unbekannt
nī = nach-unten
nijóm = führen
niktis = Mais
nínāmi = anzufreunden
nīqos = geneigt
nisdos = Nest
nitējō = Glanz
nitjos = üblich
nī́teros = minderwertig
ṇjousjom = Ungerechtigkeit
ṇjoustos = unfair
ṇkējō = brauchen
ṇkneumi = ankommen
ṇmrótijos = unsterblich
nṃtos = Biegen
nṇkskai = finden
nocējō = ablegen
nócodos = nackt
nōdos = Knoten
noibhos = heilig
nōinos = none
nokejō = zerstören
nom = so
nom nē = nicht
nōmṇ = Name
nōmnājō = Name
nomṛ = Präzision
noqterinós = Nacht
noqtis = Nacht
nosejō = frei
nōunā = Hungersnot
ṇprobhwos = böse
ṇqijētós = unruhig
ṇserós = unsere
ṇsis = Schwert
ṇsloimis = unmuddy
ṇsme = wir
ṇswodhros = außerordentliche
nū      = jetzt
numki = jetzt
ṇwidis = unwissend
n∂tis = Nates
obhi = Mitte
óbrusjā = Kolben
ochis = Wurm
odáugjai = verschlimmern
odējō = Geruch
odhrom = Gehäuse
odjō (ōda) = Hass
ōdjom = Hass
odós = Geruch
oghlejō = Ärger
oghlos = Ärger
ogmos = Titel
oidējō = geschwollen-sein
oighai = abreisen
oimos = März
óinoikos = Single
oinos = ein
oinowṛstós = gleichzeitig
oisjā = Ruder
oisos = dass
oitmi = holen
oitos = Eid
oiwos = Eibe
okējō = Zweifel
ókētā = Egge
ōkinós = bereit
okris = Gipfel
oktōu = acht
oktowos = achte
ōkúpteros = Habicht
ōkús = schnell
olejō = Wärme
olējō = zerstören
olgjā = Ranke
ōlim = früher
oljoi oljāi olja = alle
olmos = Ulme
ōlnā = Ellbogen
ólteros = weiter
óltṃos = am-weitesten
oltrōd = drüben
olwā = Segge
ōmós = roh
omos = Firma
omsos = Schulter
onbhlos = Nabel
onchis = Fingernagel
oncṇ = Salbe
oncō = Salben
oncōl = Kohle
ondos = Rock
onējō = Schuld
ónerjos = Traum
onghlos = Nagel
onjos = ein-anderes
onkājō = stöhnen
onkos = Haken
onos = Last
ónteros = zweite
ópitjos = zuletzt
opjō = wählen
opnā = Reichtum
ópopā = Wiedehopf
opos = Arbeit
opos esti = notwendig sein
ops = Reichtümer
oqō = siehe
oqos = Auge
ōrā = Kante
ōrājō = beten
orbhis = Festplatte
orbhjom = Erbschaft
orbhos = Waise
ordhos = Hammer
orgājō = verprügeln
orghis = Kugel
orghós = aufgehetzt
ormos = arm
oros = Berg
orús = hoch
ōs = Mund
osbhos = Knoten
osdos = Zweig
osēn = Herbst
oskos = Esche
ōsmi = offen
ósonos = Esche
ostis = Knochen
ōstjom = Blende
oucós = nass
oudṇ = Land
ougros = Kälte
ousis = Ohr
ṓw(ij)om = Ei
owājō = jubeln
owis = Schafe
pādhlom = Nahrung
pagos = Region
pags = Frieden
pālājō = schützen
pálejā = Stroh
pálowos = grau
palpājō = Touch
pámponos = Weinblatt
pandos = gebogen
panknos = Schwellung
pankō = schwellen
pannos = Lappen
pāpeljos = Schmetterling
paplā = Schwellung
pareikā = Konkubine
pārējō = kommen
parkō = Refrain
parsā = Spatz
pasknis = Lebensmittel
pāskō = Futtermittel
pāsmi = Acht
pāsós = relative
pastos = Fix
pāstus = Weide
pau = ein-bisschen
paukos = wenig
paulos = klein
pāwṛ = Feuer
pedjós = schlechter
pedlom = Sandale
pedom = Fußabdruck
pegtos = Brust
peidō = fett
peigō = ärgern
peikā = Specht
peikō = schmücken
peikos = Elster
peiks = Tonhöhe
peimis = schnell
peitus = Harz
pējō = Beleidigung
pekō = Kamm
pektēn = Kamm
pektō = Kamm
peku = Vieh
peldō = treiben
pelkō = bewegen
pelnis = Haut
pelō = Geld-verdienen
pelom = Oberfläche
pelsā = Rock
pelu = viel
pelupoikos = bunt
pēlwis = Gericht
pelwos = Staub
pēmṇ = Schaden
pendō = hängen
penō = Arbeit
penom = Schlamm
penos = Bestimmung
penqadkṃta = fünfzig
penqdekṃ = fünfzehn
penqe = fünf
penqstis = Faust
penqtos = Fünftel
pēnsús = Sand
pentō = Titel
peqō = kochen
peqtis = Kochen
peqtós = gekocht
peqtṓr = kochen
per(i), per(ti) = über
perijō = Erfahrung
perístānom = Religion
perknā = Forelle
pérkūnjom = Berg
perṃós = absolute
perom = neben
peróm = Feder
peros = weiter
pérperṇks = bog
perqos = Eiche
persā = Ferse
persnā = Schinken
persō = Spritzer
pertā = Pol
perti = andernfalls
péruti = letztes-Jahr
pesdō = Furz
pesnis = Penis
peterós = Flügel
pétḷos = dürftig
petō = fliegen
petsnā = Feder
petsnós = Vogel
peumi = verstehen
pewō = sauber
pibō = trinken
pigējō = lästig-sein
pikrós = scharf
pilos = Haar
pīmós = Fett
pinjos = Stich
pinkō = Farbe
pinsō = zermalmen
píperi = Pfeffer
pipjājō = quietschen
piptō = umfallen
piskis = Fisch
pitús = Lebensmittel
piwōn = Fett
plabrājai = Geplapper
plākejō = beraten
plākos = Wohnung
plākos = breit
plānos = Wohnung
plārom = Boden
plātom = Oberfläche
plātús = breit
plautos = plattfüßig
pḷdājō = Paddel
plēdhwis = Menschenmenge
plēis = mehr
plēistos = größte
plējós = mehr
plékāmi = falten
plektō = Zopf
plēmṇ  = Füllung
plēnós = voll
plētis = Füllung
pletjā = Schulterblätter
plētós = voll
pleudō = Hochwasser
pleumōn = Lunge
plewō = Fluss
plighā = Anhang
pḷmā = Palme
pḷnamaí = Ansatz
pḷnāmi = füllen
plṇgō = Streik
plousmā = Feder
ploutos = Vorstand
plówijā = regen
plówijom = Schiff
plowós = Boot
pḷowós = grau
pḷtáwijā = Erde
pḷtnos = Ebenheit
pḷtom = Mantel
plúwaidhom = führen
pḷwods = Sumpf
pṇdēks = Bauch
pneusō = atmen
pṇgō = Nagel
pṇtō = ausbreiten
podjom = Erleichterung
pods = Fuß
poimēks = Bimsstein
pōimōn = Schäfer
pojejō = sich-betrinken
polis = Stadt
polkā = Brache
polnēks = Daumen
polnō = Herbst
polpos = Szene
poltos = Haferbrei
pondos = Gewicht
pōnom = Trinkwasser
pontis = Weg
poqós = kochen
porā = Luft
porejō = vermitteln
porkos = Schwein
pornós = Feder
porsis = Stier
porsōd = weit
portājō = tragen
pos(ti) = nach
pósteri = danach
pósteros = anschließende
póstṃos = zuletzt
postrōd = rückwärts
potējō = halten
poti = Richtung
potijai = erwerben
potis = Master
pōtis = trinken
pōtlom = Glas
potmos = Spannweite
potnjā = Herrin
pōtṓr = Trinker
pougā = Gesäß
poughos = jungfräuliche
pougnos = Faust
pounā = Schwellung
poutos = Penis
powejō = sauber
póweros = Junge
powros = rein
prāi = vor
práighesto = zur-Hand
práiloghos = Gegenwart
práinōmṇ = Name
práiteri = entlang
prāmos = erste
pratis = Farn
prāwos = erste
preistos = vorhergehenden
prējō = Fan
prekō = bitten
preks = Plädoyer
premō = drücken
prepō = aussehen
presō = drücken
pretjom = Preis
pretō = realisieren
préwijos = vorhergehenden
prewō = schweben
pṛgā = Säulengang
pṛijō = gebären
prījós = Linie
prijós = liebe
prīskos = Antike
prīsmos = erste
prītis = Vergnügen
prītós = zufrieden
pṛkā́ = Furche
pṛknos = bunt
pṛkskā = Frage
pṛkskō = fragen
pṛnāmi = verkaufen
pṛnos = Vergangenheit
prō(d) = vorwärts
próbhoudhos = Aufmerksamkeit
probhwājō = beweisen
probhwos = gut
prṓddōmi = vorgebrachten
prod∂tṓr = Verräter
prōi = Morgen
proitis = Abreise
prokos  = Fortgeschrittene
prokós = Freier
promos = Auftraggeber
proqēd = in-der-Nähe
proqos = nahe
prósēdjom = Freundlichkeit
próstōrnos = verlängert
prostos = Vorgebirge
próteros = erste
proti = gegen
prōtós = zugewiesen
prousijō = reizen
pṛptus = Form
pṛqos = gefärbt
pṛsnā = Stück
pṛsom = Lauch
pṛstis = Bedeutung
pṛtis = Teil
pṛtus = ford
prunsō = einfrieren
prúsneumi = Wasser
pruswā́ = Frost
pteljā = Linde
pujō = Former
pūjós = gerecht
pukos = Schwanz
pulgā = Sperre
pūlós = faulig
pungō = Punsch
pūpos = Kind
pūrós = Kern
pusbhis = Bräutigam
pusjō = aufblasen
puslēks = Floh
pustlā = Pustel
pūtējō = rotten-faul-sein
pūterós = morsch
putlom = Kind
pūtós = sauber
puwējō = rechnen
puwos = Eiter
p∂grós = sicher
p∂gtós = fixiert
p∂ra = in-der-Nähe
p∂ros = vor
p∂strom = Seite
p∂tējō = offen-liegen
p∂tēr = Vater
p∂terā́ = Untertasse
p∂tjai = leiden
p∂trjā = Vaterland
p∂trjos = väterlich
p∂trujós = Onkel
p∂wējō = Angst
qād = die
qālis = wie
qām = wie
qāqos = wer
qasjos = Korb
qā́wṇtos = wie groß
qdnos = Magie
qe = und
qedos = magische Kraft
qedos = Winkel
qeisō = fühlen
qeistis = Berücksichtigung
qejēskō = Rest
qejō = komponieren
qejtis = Sammlung
qeklom = Rad
qekō = Blick
qeli = weit
qelō = zirkulieren
qelos = Gruppe
qelpō = Kurve
qelsō = Furche
qemō = schlucken
qentos  = heilig
qerpō = drehen
qésai = klagen
qestis = Teil
qidpe = ja
qijētis = Rest
qijētós = friedlich
qínumoi = Anspruch
qíqeimi = Schätzung
qis qid = was
qisqis qidqid = jedermann
qṃdō = wenn
qṇtjō = leiden
qodhei = wo
qoi = wo
qoinā́ = Vergeltung
qoinom = Schmutz
qoitrós, koitrós = Schönwetter
qolkā = Kissen
qolus = Spinnrocken
qom = wenn
qomde = wo
qondhros = Engelwurz
qori = warum
qorjom = Kessel
qoros = Typ
qos qā(i) qod = die
qostā = Husten
qot(j)os = wie-viele
qota = wie
qote = wohin
qóteros = die
qotrēd = wohin
qotrōd = woraus
qṛeumi = Griff
qrínāmi = kaufen
qrītóm = gekauft
qṛmis = Wurm
qṛsnos = Busch
qṛtus = Zeit
q∂ddrom = Quadrat
q∂tjō = schütteln
q∂trus = viermal
q∂trusnos = jeweils-vier
q∂twṛádkṃta = vierzig
q∂twṛádkṃtṃos = vierzigste
q∂twṛatnjom = vier-Jahre
q∂twṛdekṃ = vierzehn
q∂twṛdjówijom = vier-Tage
q∂twṛes = vier
q∂twṛkṃtémtṃos = vier-Hunderste
q∂twṛkṃtos = vierhundert
q∂twṛpods = Vierfüßler
q∂twṛtos = vierte
rādō = Rasur
rāpom = Rübe
rārós = dispergiert
rastós = glatt
raudos = Metall
raukos = zäh
rāwos = grau
ṛdhjō = wachsen
ṛdhwos = steil
rebhā = Sprung
rebhājō = Sprung
rebhō = Schild
rebhrus = Rohr
recos = Dunkelheit
rēd/re = dis
regeinā = Königin
regjos = königlich
regnom = Reich
regō = direkte
regs = König
regtós = Recht
reidhō = Fahrt
reidhos = leicht
reigō = binden
reimā = Riss
rēimṇ = Liste
rēis = Richtigkeit
reiwos = Bach
rējō = Zeile
rekā = Zecke
rékneumi = Bereich
remō = entspannen
rēmoi = rechnen
rentus = Eigentum
rēpō = kriechen
resgō = Zopf
resgtis = Seil
rēsmos = Ruder
rēti = Sieb
retō = laufen
retrōd = zurück
reubō = auskratzen
reudhos = rot
reudhos = Röte
reudō = Schrei
reudos = wild
reughmṇ = Teig
reugō = rülpsen
reumi = Gerücht
reusmṇ = Kehle
reusmnājō = wiederkäuen
rew = im-Freien
réwesnā = Ruine
rewis = Planeten
rewmṇ = Haar
rewō = abbrechen
rewos = Freiland
ṛghējō = anstiften
rigjō = Folter
ṛijai = dargelegt
rikjō = Ruine
rínāmi = wegspülen
ṛkējō = enthalten
ṛkēslom = Türreck
ṛklā = Brust
ṛneumi = bewegen
ṛnumái = versuchen
ṛnutis = Bewegung
robhos = Dach
rōdhí = auf-Rechnung
rōdhjō = bemühen
rōdō = Träne
rōdos = freudig
roinos = Damm
ros = Spray
rōstrom = Schnabel
rotā = Rad
ṛots = Wagenlenker
roudhstos = Rost
roudos = Schreien
rounā = Geheimnis
roupis = Rock
routos = intestiones
rowā = Pause
ṛsjā = Neid
ṛskai = gehen
ṛtís = Abschied
ṛtkos = Bär
rudhējō = rot-sein
rudhrós = rot
rudhsós = rötlich
rudlós = unhöflich
rugijō = brüllen
ruktus = Tunika
rumpō = Pause
runkō = Unkraut
rupús = schäbig
ruspājai = stöbern
rwtós = zusammengebrochen
r̥nāmi = Kluft
r∂bhjō = Wut
r∂djom = ray
r∂gājō = nass
r∂pjō = reißen
r∂tis = Grund
s(w)ei = wann-immer
s(w)eike = so
sāgijō = suchen
sagom = Mantel
saipis = Zaun
saitā = Haar
saitlom = Lebensdauer
saiwos = heftig
sājō = wütend-sein
sákrodhokjom = Opfer
sákrodhots = Priester
sakros = heilig
sal = Salz
saldō = Salz
salēiks = Weide
saleiwā = Speichel
salom = schwellen
salús = schmutzig
samdhos = Sand
sāmis = ruhig
samos = Sommer
sām∂n = Ruhe
sánāmi = befriedigen
sáneumi = durchführen
sankijō = erlassen
sapos = Saft
sasjom = Ernte
sātis = Zufriedenheit
sauros = sauer
sā́wel(jos)  = Sonne
se = selbst
se/sos sā/sī tod = dieser
sēd = abgesehen
sēdājō = beschwichtigen
sedējō = sitzen
sedējō ambhí = belagern
sedlā = Stuhl
sedm∂n = Siedlung
sedos = Residenz
segēts = Aussaat
seghdhlā = Pflug-Griff
seghō = halten
seghos = Sieg
seghurós = sichern
ségneumi = Falle
segnom = Falle
segō = Sau
seikā = Verein
seilō = Tropf
seimā = Band
seimṇ = Sekretion
seinus  = Kette
seiqō = verschütten
sējdhlom = Sieb
sējō = Sieb
sékāmi = Schnitt
sēknis = Ruhe
seks / sweks = sechs
sekstos = sechste
sekūris = Axt
selgō = schießen
seljos = angenehm
selkō = ziehen
selō = kaufen
sēlom = Aussaat
selom = Residenz
selwā = Eigentum
sēmi- = Hälfte
semjō = Bilge
semli = einmal
sēmṇ = Saatgut
semos = ein
senchō = singen
senējō = alt-sein
senēks = alt
senqō = Waschbecken
sentos = Pfad
sepēlijō = begraben
sépeltrom = Grab
sepō = bieten
septṃ = sieben
séptṃos = siebte
seqai = folgen
seqi = vis-a-vis
seqō = sagen
seqos = trennen
serō = treten
serom = Flüssigkeit
sēros = langlebig
sérpenos = Schlange
serpō = kriechen
sesmi = Schlaf
sesqos = Segge
setis = Besucher
sḗtjosi = weniger
seugō = saugen
seutō = kochen
sewājō = vermindern
sewe = Selbst
séwijos = seine
sewō = schüren
silējō = schweigen
síneumi = binden
sinísteros = propice
sinō = Ort
sinus = Busen
sisdō = hinsetzen
sísermi = Fluss
sísghrāmi = Geruch
síslāwos = vorteilhaft
sisō = Sau
sisqos = trocken
sītús = weit-reichend
sjewm∂n = Naht
sjewō = nähen
sjūdhlā = Ahle
sjūtós = genäht
skabhjēs = Krätze
skabhnom = Hocker
skabhō = Kratzer
skaiwós = Linkshänder
skalpō = schnitzen
skandō = mount
skandslā = Leiter
skāpos = Griff
skatējō = Schwall
skatō = Frühling
skedō = streuen
skegō = beschleunigen
skejō = Glanz
skekō = Burst
skelō = wird
skelos = Böse
skemō = Deckel
skerbhō = aushöhlen
skerdā = Scheiße
skerdō = kastrieren
skerjō = Split
skerō = Frühling
skeubhō = Flucht
skeudō = schießen
skeumō = Deckel
skeuros = dunkel
skeutō = Deckel
skewō = inspizieren
skidjō = entscheiden
skijō = wissen
skindō = Split
skīrós = klar
skīwṛ = Schienbein
skḷiqā = Schote
skḷjō = Split
skḷneumi = ablenken
skṇgjō = Hinken
sknidā = Nisse
skodhos = Schaden
skoidos = woodpiece
skoirsās = Clown
skoitom = Schild
skojā = Schatten
skolmā = Säule
skōlos = Element
skolpos = Regal
skortom = Hure
skostrom = Baldachin
skotos = Schatten
skouros = Nord
skousā = Hosen
skreibhō = schreiben
skreidō = schnitzen
skrobhis = Grube
skroupos = Scherbe
skroutos = Skelett
skubtis = Schulterblatt
skutājō = verstümmeln
skūtos = Abdeckung
slabai = Rutsch
slagós = schlaff
slakō = Hit
slatā = Stange
sleibō = Rutsch
sleidhō = gleiten
sleigō = glatt
sleimā = Datei
sleimājō = Politur
sleimāks = Schnecke
sleiwos = Violett
slējús = glatt
sleubō = Rutsch
sleugō = verschlingen
sligōn = Breithacke
sḷijai = Frühling
sloidhos = Masse
sloiwom = Pflaume
slougos = Menschenmenge
slṛgjō = Schluck
sṃ = zusammen
smā = sicherlich
smalos = Tier
smā́neumi = Fleck
smegō = Wunsch
smeidhō = schnitzen
smeighsli = Tausend
smeikā = Krume
smeirai = Wunder
smeirātlom = Wunder
smeiros = wunderbar
smeitō = senden
smejō = Lächeln
smekslā = Kinn
smelgā = Rasen
smelō = brennen
smemorjā = Speicher
smerdā = Scheiße
smerdō = stinken
smeros = Defekt
smerwā = Knochenmark
smeughō = Rauch
smitlā = Fleck
sṃlis = ähnlich
sṃloghós = Frau
sṃoitis = gemäß
sṃóp∂tōr = Geschwister
smoughos = Gasse
smoughos = Rauch
smudhnō = ersinnen
smúghneumi = Schlupf
snadhō = abschneiden
snāmi = schwimmen
sneighs = Schnee
sneitō = beschneiden
sneitos = spärlich
snēmi = Spin
snēmṇ  = Garn
snerō = Wirbel
snētjā = Stickerei
sneubhō = heiraten
sneudhs = Smog
snēw∂r = Kabel
sṇi = abgesehen
sníncheti = Schnee
snoghā = Schlange
sṇstus = Intelligenz
sṇtējō = denken
sṇterí = fehlt
snusós = Schwiegertochter
sn∂ghjō = kriechen
sodejō = begleichen
sōdjā = Ruß
sodjom = Sitz
sodóm = ging
sognos = Seil
soitos = Magie
sōlājai = Freude-geben
solkos = Furche
solpos = Öl
solwos = Ganze
solwotāts = Totalität
somejō = gleich-machen
somós = gleich
sondhos = Vorsprung
sontejō = senden
sontis = schuldig
soqjos = verbündet
sorbhējō = Schluck
sorbhos = Eberesche
sormos = Fluss
sorwā = Eingeweide
soujós = links
soukos = Saft
sówijā = Kuss
spakos = Tropfen
spáneumi = verlängern
sparos = Beitrag
sparwos = Spatz
speikā = Getreide
speiksnā = prickeln
speimis = dünn
spekjēs = Aspekt
spekjō = Flüge
spelghā = Milz
spelgis = Pol
spelō = recitate
speltā = Tabelle
spēmi = verlängern
spēnos = Nippel
speqos = Höhle
sperdhō = konkurrieren
sperghō = Eile
sperjō = streuen
spes = Hoffnung
speudō = Eile
spingjā = Fink
spjewō = Spieß
spjonos = Fingerhut
spjwtos = Spieß
spleidō = Split
spleighō = Ruhestand
splighstós = Seite
spḷndējō = hell
spḷtājō = abschneiden
spṇdō = Flattern
spoimā = Schaum
spoisājō = schwitzen
spoisnā = Atem
spoljom = Enteignung
spondejō = Versprechen
spondhā = Bett
spōnos = Stick
sponstós = verlobt
sportā = Korb
spoudā = Eile
spṛāmi = Lauffläche
spreigō = Überfluss
spreudō = beschleunigen
sprewō = erregen
spṛgō = platzen
spṛnō = wegziehen
spṛos = Knöchel
sp∂ros = florierende
sqalos = große-Fische
sqeros = Menetekel
sqijā = Dorn
sredhō = Woge
sremsō = Kampf
srenkō = Schnarchen
srewō = Fluss
srewtis = strom
srīgējō = frieren
srīgos = Kälte
sṛijō = Unkraut
sṛkijō = Reparatur
srodhos = Schwer
sroknā = Schnabel
srowmos = Stream
sṛpā = Sichel
sṛpijō = reinigen
sṛwājō = beobachten
sṛwos = Vormund
srwtom = Rohr
stādhlom = Stall
stagnom = Teich
stagō = bleiben
staknom = Pool
stālos = Couch
stāmṇ = Anordnung
stānējō = Ort
stānom = Ort
stārós = stabil
stātlom = Plattform
staurejō = gesetzt
stauros = Beteiligung
staurós = abgesteckt
stāwō = Anschlag
steighō = Spaziergang
steipēts = Stick
steiwā = Pflug-Grif
stejō = kondensieren
stejsjā = Eiszapfen
stelghō = fließen
stelō = setzen
stelōn = Ableger
stelpō = starren
stembhō = Stempel
stemō = stolpern
sterbhnjom = trockene-Haut
sterbhō = Rückgang
stergō = Liebe
sterkō = besudeln
sterkos = Scheiße
sterkos = Scheiße
sterlā = Stern
sternom = Eingeweide
sternós = starren
sterō = rauben
stérolis = steril
steros = Stern
stērps = Stamm
stertō = Schnarchen
stertos = Höhepunkt
steugō = wegschieben
steumi = informieren
steupō = Hit
steutō = Unterstützung
stigājō = Stick
stiprós = sicher
stlāmṇ = Platte
stlātos = Seite
stlītis = Klage
stlokos = Ort
stṃnos = Stamm
stṇtējō = verzögert-werden
stobhos = Säule
stoghos = Bock
stoighos = Straße
stoipejō = densifiy
stolbos = Herrscher
stolgos = Kraft
stōmṇ = Gaumen
storejō = begradigen
stornjā = Zentrum
stoudjom = Studie
stoupā = Werg
strāmṇ = legen
strātós = Verbreitung
strātos = Armee
streibā = Linie
streidō = zischen
streigō = Unentschieden
streigs = Nachtvogel
strengō = beschränken
strengom = String
strēnwos = aktiv
strepō = Lärm-machen
streubhō = bitter-machen
streudō = Kampf
strewō = streuen
strigājō = Anschlag
strigjā = Linie
stringō = ziehen
stṛneumi = niesen
stṛnō = Verbreitung
stṛnos = Erweiterung
strudsmā = Rohr
strutjos = Ahne
struwis = Haufen
studējō = thrash
stupējō = starr-sein
stupos = Stick
st∂tis = Stehen
st∂tus = Position
sū = gut
sudhjom = Bier
sujō = verschütten
sūkós = Ferkel
suljā = Bodensatz
súnoros = kräftig
sūnús = Sohn
sup = unter
supā = Suppe
supājō = werfen
sūs = Schwein
susājō = Buzz
susdos = trocken
sūtus = Geburt
suwids = Experte
swādejō = empfehlen
swādús = angenehm
swāi = so
swēdhskō = gewöhnen
swēdhus = Brauch
sweidō = Blesse
sweidos = Stern
sweighlājō = pfeifen
sweigō = Wippe
sweisdō = pfeifen
swekō = gut-riechen
swekos = duftend
swekrús = Schwiegermutter
swékuros = Schwiegervater
swelā = Sonnenlicht
swelājō = verschlingen
swelāks = Dichtung
sweljos = relative
swelō = Glanz
swelom = Schläfer
swelplos = Schwefel
swemōr = gefolgt-werden
swénāmi = Ton
swendhō = Schwindel
swepō = Schlaf
swepṛ = Traum
swerbhō = drehen
swerghō = kümmern
swerō = Flüstern
swērús = wichtig
swerwos = bissig
swesōr = Schwester
swesreinos = Schwestersohn
swīnós = Schweine
swoidājō = Schweiß
swoidos = Schweiß
swólejā = Boden
swombhós = Pilz
swonos = Lärm
swōpijō = einschlafen
swoplom = Besen
swopnjājō = Traum
swopnjom = Traum
swopnos = Schlaf
sworā = waten
swordis = Müll
sworēx = Spitzmaus
sworos = Stick
swṛneumi = Wunde
swrswrājō = Flüstern
sw∂lējō = geschwollen-sein
s∂kesnā = Spitzhacke
s∂ksom = Stein
s∂pijō = Geschmack-haben
tādējō = qualifizieren
tādhēskō = Schmelze
tādhis = Korruption
tagjō = bestellen
taismos = Teig
tājō = stehlen
tājots = Einbrecher
tálejā = Stich
tālis = wie
tām = an-diesem-Punkt
tarsós = Bauch
tárudos = langsam
tātā = Papa
tauros = Stier
tausnim = schweigend
tausos = schweigen
tā́wṇtos = so-viel
tēglā = Fliese
tegnom = Strahl
tegō = Deckel
tegos = Schrein
tegtom = Decke
tegús = dicht
teibhjā = Schienbein
teknom = Kreatur
tekō = erhalten
tekslā = Axt
teksnā = Technik
teksō = Mode
tekstā = Schüssel
tekstlom = Web
tekwō = weglaufen
telmṓn = Gurt
telpō = bekommen
telsus = Boden
tembhō = verschmähen
temesras = Dunkelheit
temkō = Ergebnis
temlom = Tempel
temos = Dunkelheit
tēmos = betrunken
tempos = Zeit
tenā = Farbband
tendō = verlängern
tenghō = ziehen
tengō = imprägnieren
teni = bis
tenjō = verlängern
tenjom = Tempel
tenos = Ligament
tensō = verlängern
tentrom = String
tepējō = warm-sein
tepnos = Fieber
teqom = Passage
tercō = drohen
téredhrom = Schnecke
tergō = wischen
tergslom = Handtuch
terjō = reiben
termēn = Ende
terō = Kreuz
terpō = genießen
terptis = Genuss
tersā = Erde
tersai = trocknen
térunos = schwach
tetkōn = Schreiner
tettā = Zitze
téturos = Truthahn
teukmṇ = Nachkommen
teukō = ausgraben
teupō = Knie
teurō = Anschlag
teusmṇ = viel
teusqa = Wüste
teutā = Menschen
tewai = beobachten
tewos = Kraft
tibhjā = Stengel
timējō = Angst-haben
titijō = zwitschern
tkeimi = etablieren
tlāmi = ertragen
tlātjos = Patient
tḷijō = Rest
tḷnō = erhöhen
tloqai = sprechen
tmāmi = Schnitt
tṃpus = elastische
tm̥klos = Sauermilch
tm̥ktos = geronnen
tṇējō = begreifen
tṇghus = Fett
tṇgō = Touch
tṇtos = ausgedehnt
tṇus = dünn
togā = Gewand
toi = sicherlich
tōkslos = Beil
toksos = Wacholder
tokwós = fugacious
tolājō = zugriffen
tolkos = Kleie
tom = dann
tom-ke = dann
tomos = Schnitt
tónāmi = mitschwingen
tondejō = Rasur
tonejō = verlängern
tongejō = ausdrücken
tonslis = Wildheit
tonstṓr = Friseur
tóntenos = Lärm
tontrom = Donner
topnos = Wärme
toqe = auch
torcós = bedrohlich
tori = daher
tórkmṇtom = Spannung
tormos = Bolzen
torós = laut
torpejō = jubeln
torqejō = drehen
torqis = Halskette
torsejō = trocken
torsmṇ = Donner
tot(j)os = so-viele
totrēd = dorthin
totrōd = von-dort
toughā = Glück
touknā = Schenkel
trabhis = Strahl
traghō = ziehen
traghsmā = Schuss
trāntis = durch
trebhō = wohnen
tregsnos = tapfer
treistis = traurig
trejes trija trísores = drei
tremō = zittern
trenkō = anstiften
trepō = Pass
tresō = Schauer
treudō = zwingen
treughos = elend
treukō = ausschneiden
tríj∂tos = Meer
triplós = dreifach
trípḷtis = Verdreifachung
trĩs = dreimal
trisnôs = drei-in-Reihe
tristis = Zeuge
tritjos = Drittel
trītós = gerieben
tṛmēts = Keil
tṛmos = Termite
tṛnā = Dorn
troghos = Nachwelt
trogjā = Sau
trogos = Schwein
tropos = Weg
trosejō = Angst-machen
troughi = ach
trowā = Schöpfkelle
trowō = nagen
tṛpējō = träge-werden
tṛrpis = hässlich
tṛsdos = Strahlfäule
tṛsējō = durstig-sein
tṛstis = Durst
tṛstos = trocken
tṛsus = trocken
trudskā = Lepra
trudsmós = ärgerlich
truks = Schlächter
tū = Sie
tūljom = Vielzahl
tumējō = geschwollen-sein
tumlós = Hügel
túmolos = Aufruhr
tundō = Streik
turgējō = schwellen
tūrjós = Käse
tursis = Turm
tusjai = sich-freuen
tusnā = Welle
tustijō = Husten
tustis = Husten
twakos = Rüstung
twenkō = Kraft
twerō = umschließen
twoisós = gewalttätig
twṛbhōn = Wirbel
twṛkos = Wildschwein
twṛmā = Trupp
twṛtos = schnell
t∂kējō = schweigen
ucējō = nass-sein
ud = aus
úderos = uter
ūdhṛ = Euter
ūdhros = Euter
ūdhús = sofortige
udsqe = oben
ughḗn = Hals
uksōn = Ochse
uksōr = Frau
ululājō = heulen
unksrā = Schatten
upelos = schlecht
úperesū = sehr-gut
uperi = über
úperos = hoch
upo = unter
upóqrijom = Provision
upósēdjom = Fundament
upóstānom = Service
úpselos = hoch
upsi = oben
uqnós = Owen
urús = breit
ustós = verbrannt
uta = eher
wadhis = Vorsicht
wadhō = Spaziergang
wadhom = ford
wageinā = Scheide
wāghijō = Schrei
wai = ach
wailós = Wolf
wailos = demütig
wakkā = Kuh
walgos = O-Beine
walnom = Wand
walóm = gestorben
wapējō = neblig-werden
waplājō = Schrei
warnā = Eule
wāros = Beinen
wāstos = leer
wātis = Dichter
watjos = legbent
we = oder
webhō = weben
wédhneumi = Link
wedhō = führen
wedhṛ = Waffe
wedhrom = Wetter
wedhskō = Streik
wedmṇ  = Äußerung
wedō = sagen
weghjā = Weg
weghō = tragen
weghtis = Leuer
weghtlom = Fahrzeug
weghtṓr = Transporter
wegō = weben
wegō = stark-sein
weidhō = Kluft
weidos = Gegenwart
weidr̥ = Tier
weiks = Haus
wéiktomā = Opfer
weimṇ = Webstuhl
weipō = wickeln
weiros = Draht
weis = Stärke
weisnā = Vene
weisō = Fluss
weitēks = agnus-castus
weitis = Rebe
weitō = Bogen
wéiwersā = Frettchen
wejes / weje = wir
wekmi = Wunsch
wekō = Bogen
weksós = konvex
weldō = abreißen
welīks = Armband
welmi = wird
welnā = Welle
welnos = Haar
welō = siehe
welpō = erwarten
weltis = wird
wélwṃen = Verpackung
welwō = drehen
wélwtrom = Umschlag
wémāmi = erbrechen
wēmos = schön
wḗnāmoi = streben
wendhō = Angriff
wenēsnom = Liebestrank
wenjā = Familie
wenō = Wunsch
wenos  = Liebe
wenseikā = Blase
went = ausgestattet
wentos = Wind
weqtis = Sache
weqtlom = Ausdruck
wēr = Tür
werbos = Peitsche
wereinā = Sekte
wergō = Richtung
wergom = Arbeit
weri = Wasser
werjō = Name
wernā = Erle
wēros = wahr
werpō = wickeln
wersis = männlich
wersmṇ = Warze
wersō = ziehen
werstidhlom = Halle
werstis = Titel
wertm∂n = Richtung
wertos = Wert
wertrom = Verteidigung
wérunos = Gürtel
weskai = essen
wēskō = squeeze
wésnāmi = stechen
wesnejō = Schnäppchen
wesnom = Verkauf
wesō = Aufenthalt
wésolis = billig
wespros = Abend
wesṛ = Frühling
wēsros = Morgen
westā = Lebensmittel
westijō = Kleid
westis = Tuch
westos = Fest
westus = Wohnung
wēsus = ausgezeichnet
wétāmi = verbieten
wetlos = Kalb
wetos = Zeit
wetsós = year
wetwos = alt
wī = auseinander
wibrājō = vibrieren
widā́ = Aussehen
widējō = siehe
wídhewā = Witwe
widhus = willlow
widjom = Weisheit
wigējō = stark-sein
wijējō = gekrümmt-sein
wijēskō = welken
wikis = Chance
wikjō = kämpfen
wikkā = Hexe
wíklutom = bekannt
wikwos = vielfältig
windō = wo
windō peri = untersuchen
windos = offensichtlich
winis = Kabel
winkijō = Fessel
winkō = gewinnen
winsō = Ursache
wīrós = Mann
wisējō = sprießen
wiskom = Mistel
wísogā = Verein
witājō = umdrehen
wíteros = ergänzende
wītjā́ = Rahmen
witjom = Kurve
witus = Felge
wíweqmi = sprechen
wḷbhontis = Kamel
wḷdā́ = Fest
wḷdhējō = Regel
wḷeiqos = Flüssigkeit
wḷeisō = schlagen
wḷējō = fit-sein
wḷepējō = Peitsche
wḷeumi = Plünderung
wlewā = Löwe
wḷghis = Becken
wḷiqējō = flüssig-sein
wḷnā = Wolle
wḷōrom = Gurt
wḷqos = Wolf
wḷtis = Tuff
wḷtus = Eindruck
wṇdā = Welle
wṇghējō = kompliziert-werden
wochējō = Gelübde
wodā = Wasser
wodṛ = Wasser
woghejō = induzieren
woghnos = Auto
woghos = Verkehr
wogsmis = Pflugschar
woida = wissen
woidejō = orientieren
woidlos = Korb
woidwṓs = Wissenswertes
woighos = Ulme
woikā = Vitalität
woikos = Dorf
woikós = standhaft
woikslā = Bauernhof
woinā = Strafe
woinos = Wein
woisos = Gift
woitā = Jagd
wolējō = wählen
wolgos = Menschen
wolmos = rollen
wolnos = Wunde
wolos = Wahl
wolós = bereit
wolpis = Fuchs
wolsom = Schaden
wolwós = Runde
wondhejō = Wind
wondhos = Haar
wōnós = leer
wopjā = Wasser
wopsā = Wespe
woqs = Stimme
worgjom = Cannabis
wormis = Wurm
wornos = Farbe
worós = Polizist
wortejō = umkehren
wosejō = Kleid
wosis = Turban
wosmós = nass
wospos = Gewand
wṛaghmṇ = Rückgrat
wṛdhom = Wort
wṛdjā = Wurzel
wṛegis = Gehäuse
wṛeikā = Schleier
wṛéikonjom = Gurtband
wṛeinā = Harn
wṛējai = Achtung
wṛēn = Lamm
wṛeumi = schließen
wṛeumi apo = offen
wṛgā = Vitalität
wṛgējō = auf-Angriff
wṛgjō = Arbeit
wṛgos = Angriff
wṛijō = schließen
wṛisdējō = Lachen
wṛnāmi = verfolgen
wṛṇgai = schimpfen
wṛonkā = Hand
wṛonkis = tauchen
wṛrādīks = Wurzel
wṛstā = regen
wṛstis = drehen
wṛstos = Zeile
wṛtō = drehen
wṛtom = Gehäuse
wṛughis = Roggen
w∂drā = Otter
w∂dris = Ledertasche
w∂gājai = wandern
w∂nskā = Wunsch
w∂nskō = Wunsch
w∂rbhis = Perimeter
w∂rjō = anbrennen
w∂ros = Pickel
∂gjō = bestätigen
∂gsājō = verkünden
∂gtis = Rede
∂pjō = erreichen
∂snātis = Ernte